5 5
11111
12221
12221
12221
11111
-
6 8
111111
122221
122221
111221
122221
112221
122221
111111
-