7 7
1111111
1222221
1222221
1222221
1222221
1222221
1111111
-
10 8
11111111
12222221
12222221
11122221
12222221
11222221
12222221
12222111
12222221
11111111
-
6 8
11111111
12212221
12222211
12222211
11222221
11111111
-
9 9
111111111
122122121
122222221
112222211
111222111
112222211
122222221
122122121
111111111
-
14 14
11111111111111
11111111111111
11111111111111
11111111111111
11111111111111
11111111111111
11111111111111
11111111111111
11111111111111
11111111111111
11111111111111
11111111111111
11111111111111
11111111111111
-
