-
7 7
1111111
1222221
1222221
1222221
1222221
1222221
1111111
-
10 8
11111111
12222221
12222221
01122221
12222221
11222221
12222221
12222100
12222221
11111111
-
6 8
11111111
12212221
12222210
12222210
01222221
01111111
-
