7 7
1113111
1222221
1222221
3222223
1222221
1222221
1113111
-
10 8
11113111
12222221
12222221
12222221
32222223
12222221
12222221
12222221
12222221
11113111
-
6 8
11131111
12222221
12222223
32222221
12222221
11113111
-
9 9
111131111
122222221
122222221
122222221
322222223
122222221
122222221
122222221
111131111
-
