5 5
11111
12221
12223
14221
11111
-
5 5
11111
12223
12111
12421
11111
-